1111111111111111111
1110000000000001111
1000111100001100001
10111100TT00001T0C1
1001100011C100111T1
1E11111100110TC0001
1110011000000011111
1100111000T11000001
1P00000C11100000001
1111111111111111111