111111111111111
10C1000000000C1
100000011111001
1P000T11E00C001
111111111111111