1111111111111111111
1E000C00000C0000001
1011010010000011001
1011001010101100101
1P0000TC00C0000T0C1
1111111111111111111