111111111111111111111111111
100000000000CCC000000111111
100111110000111000000000001
101111C00000000001100000001
10C11CC011111111C1000011101
1C111111111111C01100001CCC1
1110C11C0000000000000011111
110011100000C11111011000001
1P0000001111111E00001111CC1
111111111111111111111111111