1111111111111111111
11100000CCC00001111
1000111100001100001
101111C000000110001
10C11CC011C10011101
1C111111C011001E001
1110C11C00000011111
1100111000C110000C1
1P000000111C00000C1
1111111111111111111