1111111111111111111
1110000000000001111
1000111100001100001
10111100000000110C1
1001100011C10011111
1E111111001100C0001
1110011000000011111
1100111000011000001
1P00000C11100000001
1111111111111111111